====================
=................*.=
==========.........=
=....===......======
=..................=
=.......=====......=
====================
