====================
=..................=
=====...==.........=
=....===......======
=...g..............=
=.......=====......=
=...==........==...=
=.......=====......=
=..................=
====================
