====================
=................*.=
==========.........=
=....===......======
=.............g....=
=.......=====......=
=....G........==...=
=.......=====......=
====================
