====================
= .................=
=====...==.........=
=..................=
=....===......======
===................=
=.......=====......=
=...==........==...=
=.......=====......=
=...g..............=
====================
