====================
=..................=
=====...==.........=
=....===......======
=..................=
=.......=====......=
=...==........==...=
=.......=====......=
=...g..............=
====================
